Давайте разберем каждое поле в данном JSON-объекте, чтобы понять, что оно означает:

figi: Уникальный идентификатор облигации по стандарту FIGI (Financial Instrument Global Identifier). В данном случае это "TCS00A107D74". Этот идентификатор используется для точной идентификации финансового инструмента.

ticker: Тикер облигации — это уникальное короткое обозначение для облигации на фондовой бирже. В примере это "RU000A107D74", что также является уникальным символом для идентификации облигации на Московской бирже.

classCode: Код класса инструмента на бирже. Это может быть код, который определяет тип финансового инструмента, в данном случае это "TQCB".

isin: ISIN (International Securities Identification Number) — международный идентификационный номер ценной бумаги. Здесь он равен "RU000A107D74" и используется для международной идентификации облигации.

lot: Размер лота, то есть минимальное количество облигаций, которое можно купить или продать в одном блоке. В данном случае это "1", что означает, что покупка и продажа возможны только в единичных лотах.

currency: Валюта, в которой номинирована облигация. В данном случае это "rub", что означает, что облигация номинирована в российских рублях.

shortEnabledFlag: Флаг, указывающий, разрешена ли короткая продажа облигации (short selling). В примере значение false, то есть короткая продажа невозможна.

name: Название облигации. В данном случае это "ЭнергоТехСервис 001P-05" — название конкретной облигации.

exchange: Биржа, на которой торгуется облигация. В примере это "MOEX", что означает Московская фондовая биржа.

couponQuantityPerYear: Количество купонов (процентных выплат), которые облигация выплачивает в год. В примере это значение "12", что означает ежемесячные выплаты.

maturityDate: Дата погашения облигации. В примере это "2025-12-02T00:00:00Z", что означает, что облигация погашается 2 декабря 2025 года.

nominal: Номинальная стоимость облигации. В данном случае "832 rub" — номинальная стоимость одной облигации составляет 832 рубля.

initialNominal: Изначальная номинальная стоимость облигации. В примере "1000 rub".

stateRegDate: Дата регистрации облигации в государственных органах. В примере "2023-12-06T00:00:00Z".

placementDate: Дата размещения облигации на бирже. В примере "2023-12-13T00:00:00Z", то есть облигация была размещена 13 декабря 2023 года.

placementPrice: Цена облигации при размещении. В примере "1000 rub".

aciValue: Значение ACI (Accrued Coupon Interest — начисленные проценты) для облигации. В примере "6.3 rub".

countryOfRisk: Страна, с которой связаны основные риски по облигации. В примере это "RU", что означает Россию.

countryOfRiskName: Название страны риска. В данном случае это "Российская Федерация".

sector: Сектор экономики, к которому относится облигация. В примере "industrials", что означает промышленный сектор.

issueKind: Тип выпуска облигации. В данном случае "non_documentary", что означает бездокументарный выпуск.

issueSize: Размер выпуска облигаций, то есть общее количество облигаций в данном выпуске. В примере "1000000" облигаций.

tradingStatus: Статус торгов по облигации. В примере "SECURITY_TRADING_STATUS_NORMAL_TRADING", что означает, что облигация доступна для обычных торгов.

otcFlag: Флаг, указывающий, доступна ли облигация для торговли вне биржи (Over-the-counter). В примере "false", значит, торговля вне биржи недоступна.

buyAvailableFlag: Флаг, который указывает, доступна ли облигация для покупки. В данном случае "true", что означает, облигацию можно купить.

sellAvailableFlag: Флаг, который указывает, доступна ли облигация для продажи. В данном случае "true", что означает, облигацию можно продать.

floatingCouponFlag: Флаг, который указывает, имеет ли облигация плавающий купон (процент). В данном случае "false", что означает фиксированный купон.

perpetualFlag: Флаг, указывающий, является ли облигация бессрочной. В примере "false", то есть это не бессрочная облигация.

amortizationFlag: Флаг, который указывает, погашается ли облигация частями или нет. В примере "true", то есть погашение облигации происходит частями.

minPriceIncrement: Минимальное изменение цены при торгах. В примере это "0.00000001 rub".

apiTradeAvailableFlag: Флаг, который указывает, доступна ли облигация для торгов через API. В примере "true".

uid: Уникальный идентификатор облигации. В примере это "d0f5de81-daac-4cdf-94b5-90b32cb3418c".

realExchange: Реальная биржа, на которой торгуется облигация. В данном случае "REAL_EXCHANGE_MOEX", то есть Московская биржа.

positionUid: Уникальный идентификатор позиции облигации на бирже.

assetUid: Уникальный идентификатор активов облигации.

forIisFlag: Флаг, указывающий, доступна ли облигация для покупки через ИИС (Индивидуальный инвестиционный счет). В примере "true", то есть облигацию можно приобрести через ИИС.

forQualInvestorFlag: Флаг, указывающий, доступна ли облигация для квалифицированных инвесторов. В примере "false", значит, облигация доступна для всех инвесторов.

weekendFlag: Флаг, указывающий, торгуется ли облигация в выходные. В данном случае "false".

blockedTcaFlag: Флаг, указывающий, заблокирована ли облигация для торговли. В примере "false", значит, облигация доступна для торговли.

subordinatedFlag: Флаг, указывающий, является ли облигация субординированной. В примере "false", значит, облигация не является субординированной.

liquidityFlag: Флаг, который указывает, обладает ли облигация ликвидностью. В примере "true", значит, облигация ликвидна.

first1minCandleDate: Дата первого торгового значения (кандела), полученного на минутном графике. В примере "2023-12-13T13:33:00Z".

first1dayCandleDate: Дата первого торгового значения на дневном графике. В примере "2023-12-13T07:00:00Z".

riskLevel: Уровень риска облигации. В примере "RISK_LEVEL_MODERATE", то есть умеренный уровень риска.

brand: Информация о бренде, связанная с облигацией. В данном случае это включает логотип и цветовую схему для визуального представления облигации.

bondType: Тип облигации. В примере "BOND_TYPE_UNSPECIFIED", что означает, что тип не указан.